##################################################
##OO............#..........O.O..O.O.....O..O..O..#
#O...#.O.O.O....#OO.#O....#.........O.#..........#
#O....O..O.OO.OOO.#.....O#.....#..#O.OO..........#
#.O#OOO...O............O##......#..O..O......O..##
#......#....#...OO....O.#OO..O.OO.OO.O#........#.#
#...O...##.....OO...O..#...O....O....O.....O...O.#
##.O.#...##....O..............#....O....O.O..O#.O#
#.OO#...O........O......#.#O...OO.OO...O.O.#....##
#O....O...O.O.O.#.#OO.O#.O....#..O..O...#....OO..#
#O.O..OO..##.....#.#O..O.O.OOO.....O..#.O..#.....#
#.....OO..O...O.OO..#......O...O...O..O.#........#
#..O..O#.O.O.O..#.O.O..OO....#....O#.....O.OO..O.#
#..#O#..O..O.....#.#O...O..OO#.OO..OO...........O#
#..............O#O..#OO..OO...OOO.....O#..#...O.##
#....OO..#...O..#..O.#..OOO........#OO.O.O..O....#
#O#.#.O.O.OO..O.....OO..##....O..O........#.O....#
#.O.O.O.O#O..#.....O#.OO.#O.....O.O......O..O....#
#O.....O#O...O#....OO.OO.......O.O...O.......O...#
#....OO....O.O..O.#.......OOOO...O.O..OO....OO...#
##.....O....O..O.O..OOOO.....#...OO.....O#...#..O#
#O.#...O...O.O.O.OO.O...#....O..O.OO..O...O#..O.O#
#....O.#O.OOOOO..OO...OOO.#OO.O...O...O...O..O...#
##O.....#O.....O....O..O.O...O...O.O..OO.O.O...O.#
#......#.O#.O...#....OO.@#.....##..#.OO#....#....#
#OOO...O..OO.........O.#.O....O#...O.OO....#O...O#
#...OO..O..O#...O..O.#O.O.O#............O......O.#
#OO.O.OO..OO.#....O....O.....OO....O..O..O.OO...O#
#..O.O.O...OO.#..OO..#O....O...#...OO...O.O.O#OO.#
#O.OO#..O..........OO....#...#..#.#..O........O..#
#..##..OOO...#.#.....##.O..O..#..#O.......O#.O.OO#
#O.O.#.O.O..#.OO.#O..O...O..#..OO.OO..O.O..OOOOO.#
#.#O..OOO#..#.....O.O...O...O.OO....OO.OO#O#O#O#O#
#...O.O.#...#O....O.OOO...O.#.....O..O.O.......OO#
#..OO.......O.O..OO#.....OOOOO.....O.OO..#O...OO##
#.....O..#.O.......O...O....OO.O.........O.......#
#..O.O.........O....O.#O.....#....#.O....#O......#
#..##....O.O...O..O.O..##O...#....O#O.......OO#O##
##OOOO.O.O.O.OO.........O..O........O#O..O....#OO#
#..OO#...O...OO.....#.OOO....OO.OOO..O.O..OOO.O..#
#O..OO..O..OO............O.#..#O..O...O..##OOOO#O#
#...O..O#..O.O....O..O...O....#.#O.OO.O...#O.OOO.#
#......O.....O...OO..##.O.O...O....O...O....O....#
#O.O.#O.#O..O..OO.#O#..O..O..O.#.O...O.O...OO.O..#
#.OO....#OO.O...O.O.#...#.O.O..O#......O........O#
#....O.#O.OOO....O.O#..O.O.#..O.....O.OOO.O.#.##.#
#..#O..#.....OO....O.O.O.O.O..#..O.O#..OO.....O..#
#...O.............OO..#....#O......O..O.OO.O#.O.O#
#...#..O..O...O.#O.O.O.....OOO..OO#......O..OOO..#
##################################################