####################
##........[]......##
##........[]......##
##................##
##................##
##................##
##........[]......##
##........[]......##
##........@.......##
####################