####################
##................##
##................##
##................##
##.@[][]....[]....##
##................##
##................##
##................##
##................##
####################