####################
##........#.......##
##...[][][][][][].##
##....[][][][][]..##
##.....[][][][]...##
##......[][][]....##
##.......[][].....##
##........[]......##
##.........@......##
####################