####################
##................##
##................##
##................##
##.[]....[][]@....##
##................##
##................##
##................##
##................##
####################