####################
##................##
##................##
##................##
##.@.[].[]##[]....##
##................##
##................##
##................##
##................##
####################