####################
##................##
##................##
##................##
##................##
##.........#......##
##.......[][].....##
##........[]......##
##.........@......##
####################