##################################################
#...O.....O.O.O#..O.....#.OOO..O#.....O..O#..O#..#
#.O.#.O#.........#O..O..#O...O..O#......O..O.....#
#...O..O...OO..O#..OO#.O.......................O.#
##....#OO....O.O#.OO#.OOOOO...#OO.OO....#O....#..#
#O...#.O...###.OOO...O.OO..#....OOOO#O.O.......O.#
#OOOO..O#O.O.O..OOO..O....O......#OO.O..O..O.....#
#....#O.O....OO.......O...OO..O.O.O..O......OO#O##
#....OO........#O...#.O....O.OO...O.OOO.........##
#.#OOOO..O.O......O..O...OOO....OO.#OO.#.........#
##OO......O.OO..#...OO.O##.O....OO..O.....#......#
#O..O.##O....O...##.O....O..#..O...O.O........O..#
#O......#.....O.OO..O......O...#...O....O.O..OO..#
#...O..OO.OO.....O#OO.....O..OO.#.....OO..O..##..#
#.#.O#.O..O...............O..O......#....#....O..#
#O...O....O.....O....O...#..##.#......O..O...##..#
#..O.OO.....O.##OO.OOO..O......O.O.O...O..O.O.O..#
#...##..O..O.O.........OO.O.#.O.O...O...OO......O#
##...O#.......OO.O....##....##O.OO.OO.O....#.....#
#.O.OO#...OOOO#..O..O..#..OO..O......O..O....#O.O#
#..O........OOOO#OO.OO...........O.O..OO....OO...#
#..OO.OO#.OO...O........#..O..O..#OO#.....O..O...#
#O....O..OOOOO...O.#...O.#.#.O.........OOO#.O...O#
#O....OOO.O...O.OO......O.O#.O.O..#O..O#.OOO..O.O#
#O........O.OO...#...O..@......O.O..#O..OO.O.#..O#
#OO....#.O......OOO..O.......OO....O#.OOOO.O.....#
#.O.O.O...OOO..O.OOO.O#.O#O...OOO#..#.......OO.#.#
#.O..#.OO..#.#...O.........O....O..O.....O.OO.O.O#
#.O#OO.O..O#....O......O...O#.O..O.OO.O...#O....##
#..O.OO..O.#..........#.O....OOOOO#OO.....OOOO.#.#
#.O..O.........O##O....O.#.#......OO.....O..#.O#.#
#.#..O#.#...#...O.....O..#.....OOO..O#.O..O##O...#
#.O#..O...OO..O...O.#..O.O....O..OO..O.......O..O#
#...O.OO...O....O.......#O.O.O##.O...O..O#...OO.O#
#....O.OO...O....O...O....#.#..#..O...#.O.O.#....#
#.OO.#.#..OO#....O.O..#..#..O.O..O......O..O.O...#
#..O...O#.O...OO....OO...O.#..O...#.....#...O#O.##
##..O..O.#.O...O..O..O..#.......O..O..O#..O.O...O#
##....O...O.O..OO......O...O.OO..#.O#..........OO#
#O...O..O#O...OO...OO.O.....O...O.#....O.O..O..O.#
#....O...O.OO....#O.O...#.#......O.#...O...#...#.#
#.....O..O.O...OOO#O..#OO.O...O...O..OOO...O...O.#
#O#O....O#....O.#..OOO....OO...#...#......#..O.O.#
#OO..#.....#.O...OO...O#.O.O.O..#....#O.O.....#..#
#...O....#O.O.O..#..OO...#.OO....#..#.O......O...#
#O....OO..OO.OOOO...OO....O.....O...#..OO.#.#....#
#O....O..........OOO.O..OO.O..O..#..O#..OO..O...O#
#.O.OO..O....O....#O#O......#...O###...#O....O..O#
#.#O.....O..O...#O.....#O........O.OO....O.#....##
##################################################