##########
#....O...#
#....O...#
#........#
#....@...#
#........#
#....O...#
#....O...#
#........#
##########