####################
##[]......[]......##
##........[]......##
####..............##
##........@.....####
##....##..........##
##........[]......##
##........[]......##
##..........[]....##
####################