####################
##........[]......##
##........[]......##
##................##
##........@.......##
##................##
##........[]......##
##........[]......##
##................##
####################