####################
##................##
##................##
##.......[].......##
##........##......##
##......[]........##
##.......@........##
##................##
##................##
####################